pee_..p._._e_..._..__ep_.
.e___e._.__.ppe.p_ee..._.
._.ee..__._ep._e_...__e..
e_ee_.ee_..._e_ep.p.....p
ee_eep_..e.._e.e.e.e.ee_e
.._p.ee...p_ee__..__.pp__
ep.e___.p._e._._..p__._..
e.epp_......e.e__epp._ee.
p.ee_peeep..pe_p.p_.ee_._
